################
#  *           #
#  *      E    #
#  *           #
# *********    #
#    ######    #
#  *********   # 
#      ##      #
#       #   E  #
#   F   #      #
#  M    #  Y   #
#       #    E #
#  ********    #
#      X       #
################