########
# .. p #
# o o  #
#      #
########