######
# ..p#
# oo #
#    #
######