########
# .. p #
# oo   #
#       #
########