####################
#  *               #
#  *      E        #
#  *               #
# *********        #
#    ######        #
#  *********   B   #
#      ##          #
#       #   E      #
#   F   #          #
#  M    #  Y       #
#       #    E     #
#  ********        #
#    X             #
####################