######
# ..  P #
# oo  #
#      o#    
#####