######
# P. #
#.o o#
#. o.#
######