######
# .. o  .#
# oo   #
# p   #   
#####