######
# .  #
# oo #
# p  #   
######