######
# .  .   #
# oo  #
# p    #   
#####