######
# ..   .#
# oo  #
# p    #   
#####