######
# .P.  #
# oo #
#      #   
#####