######
# ..   . #
# o   #
# p    #   
#####