######
# ...#
# oo.#
# P  #
######