######
# .. p#
# oo  #
#    #   
#####