######
# .  #
# oo #
# po #
######