######
# .. #
# oo #
# p  #
######