######
# .. #
# oo#
# p #
#####